//--------------------------------------------------------------------------------------//
//----------------------------------------abclib----------------------------------------//
//
//-------------------------------FAUST CODE FOR MIXED MUSIC-----------------------------//
//
//-------------------------------- BY ALAIN BONARDI - 2019 -----------------------------//
//--------------------------------------------------------------------------------------//

declare name "abc_map1";
declare author "Alain Bonardi";
declare licence "GPLv3";

import("stdfaust.lib");
import("../abccommon/abc2dmap.dsp");

//--------------------------------------------------------------------------------------//
//HOA ENCODER//
//--------------------------------------------------------------------------------------//
ao = 1; //ambisonic order is 1//


//--------------------------------------------------------------------------------------//
//PROCESS FUNCTION
//--------------------------------------------------------------------------------------//
process = ho.map;